20
0 0 0 1 21 2 174 4 119 5 294 6 329 7 514 8 580 9 917 11 736 13 764 -999
1 0 19 1 0 2 164 4 108 6 319 7 504 8 570 9 907 11 727 13 754 -999
2 0 173 1 164 2 0 6 458 7 526 8 519 9 840 -999
3 4 106 5 71 6 169 7 420 8 491 9 964 -999
4 0 120 1 108 3 106 4 0 5 176 6 239 7 476 8 561 9 910 12 717 13 751 -999
5 0 294 3 71 4 176 5 0 6 143 7 350 8 443 11 577 -999
6 0 329 1 319 2 458 3 169 4 239 5 143 6 0 7 238 8 322 11 481 -999
7 0 514 1 504 2 526 3 420 4 476 5 350 6 238 7 0 8 96 11 238 -999
8 0 580 1 570 2 519 3 491 4 561 5 443 6 322 7 96 8 0 9 490 10 376 11 174 13 368 -999
9 0 917 1 907 2 840 3 964 4 910 8 490 9 0 10 309 17 609 18 144 19 507 -999
10 8 376 9 309 10 0 12 244 13 79 -999
11 0 736 1 727 4 717 5 577 6 481 7 238 8 174 11 0 12 48 -999
12 4 751 10 244 11 48 12 0 13 194 -999
13 0 764 1 754 8 368 10 79 12 194 13 0 14 192 15 328 -999
14 13 192 14 0 15 125 -999
15 13 328 14 125 15 0 16 127 17 161 -999
16 15 127 16 0 18 130 -999
17 9 609 15 161 16 130 17 0 18 685 -999
18 9 144 17 685 18 0 19 365 -999
19 9 507 18 365 19 0 -999