0 21 174 -1 119 294 329 514 580 917 -1 736 -1 764 -1 -1 -1 -1 -1 -1 
19 0 164 -1 108 -1 319 504 570 907 -1 727 -1 754 -1 -1 -1 -1 -1 -1 
173 164 0 -1 -1 -1 458 526 519 840 -1 -1 -1 -1 -1 -1 -1 -1 -1 -1 
-1 -1 -1 0 106 71 169 420 491 964 -1 -1 -1 -1 -1 -1 -1 -1 -1 -1 
120 108 -1 106 0 176 239 476 561 910 -1 -1 717 751 -1 -1 -1 -1 -1 -1 
294 -1 -1 71 176 0 143 350 443 -1 -1 577 -1 -1 -1 -1 -1 -1 -1 -1 
329 319 458 169 239 143 0 238 322 -1 -1 481 -1 -1 -1 -1 -1 -1 -1 -1 
514 504 526 420 476 350 238 0 96 -1 -1 238 -1 -1 -1 -1 -1 -1 -1 -1 
580 570 519 491 561 443 322 96 0 490 376 174 -1 368 -1 -1 -1 -1 -1 -1 
917 907 840 964 910 -1 -1 -1 490 0 309 -1 -1 -1 -1 -1 -1 609 144 507 
-1 -1 -1 -1 -1 -1 -1 -1 376 309 0 -1 244 79 -1 -1 -1 -1 -1 -1 
736 727 -1 -1 717 577 481 238 174 -1 -1 0 48 -1 -1 -1 -1 -1 -1 -1 
-1 -1 -1 -1 751 -1 -1 -1 -1 -1 244 48 0 194 -1 -1 -1 -1 -1 -1 
764 754 -1 -1 -1 -1 -1 -1 368 -1 79 -1 194 0 192 328 -1 -1 -1 -1 
-1 -1 -1 -1 -1 -1 -1 -1 -1 -1 -1 -1 -1 192 0 125 -1 -1 -1 -1 
-1 -1 -1 -1 -1 -1 -1 -1 -1 -1 -1 -1 -1 328 125 0 127 161 -1 -1 
-1 -1 -1 -1 -1 -1 -1 -1 -1 -1 -1 -1 -1 -1 -1 127 0 -1 130 -1 
-1 -1 -1 -1 -1 -1 -1 -1 -1 609 -1 -1 -1 -1 -1 161 130 0 685 -1 
-1 -1 -1 -1 -1 -1 -1 -1 -1 144 -1 -1 -1 -1 -1 -1 -1 685 0 365 
-1 -1 -1 -1 -1 -1 -1 -1 -1 507 -1 -1 -1 -1 -1 -1 -1 -1 365 0 
