8
0 2 2 1000
1 2 6 3 8 6 9 1000
2 0 2 1 6 4 8 1000
3 1 8 7 3 1000
4 2 8 6 3 7 8 1000
5 7 9 1000
6 1 9 4 3 7 4 1000
7 3 3 4 8 5 9 6 4 1000
