30
0 0 0 1 21 2 174 4 119 5 294 6 329 7 514 8 580 9 917 11 736 24 309 25 242 26 391 28 666 -999
1 0 21 1 0 2 164 4 108 6 319 7 504 8 570 9 907 11 727 13 754 24 300 25 234 26 382 27 575 28 597 -999
2 0 173 1 164 2 0 6 458 7 526 8 519 9 840 24 202 25 225 26 284 27 508 -999
3 4 106 5 71 6 169 7 420 8 491 9 964 25 313 26 492 27 631 -999
4 0 119 1 108 3 106 4 0 5 176 6 239 7 476 8 561 9 910 12 717 13 751 25 258 27 579 -999
5 0 294 3 71 4 176 5 0 6 143 7 350 8 443 11 577 25 338 26 494 27 646 28 412 -999
6 0 329 1 319 2 458 3 169 4 239 5 143 6 0 7 238 8 322 11 481 24 405 25 228 26 336 27 475 28 340 -999
7 0 514 1 504 2 526 3 420 4 476 5 350 6 238 7 0 8 96 11 238 24 364 25 290 26 286 27 424 28 97 -999
8 0 580 1 570 2 519 3 491 4 561 5 443 6 322 7 96 8 0 9 490 10 376 11 174 13 368 24 360 25 345 26 302 27 316 -999
9 0 917 1 907 2 840 3 964 4 910 8 490 9 0 10 309 17 609 18 144 19 507 20 510 21 560 27 332 -999
10 8 376 9 309 10 0 12 244 13 79 28 427 -999
11 0 736 1 727 4 717 5 577 6 481 7 238 8 174 11 0 12 48 25 495 28 146 -999
12 4 751 10 244 11 48 12 0 13 194 25 536 28 200 -999
13 1 754 8 368 10 79 12 194 13 0 14 192 15 328 28 377 -999
14 13 192 14 0 15 125 -999
15 13 328 14 125 15 0 16 127 17 161 20 336 22 748 23 779 -999
16 15 127 16 0 18 130 22 735 23 766 -999
17 9 609 15 161 16 130 17 0 18 685 20 184 22 596 23 627 -999
18 9 144 17 685 18 0 19 365 20 504 -999
19 9 507 18 365 19 0 20 742 21 428 -999
20 9 510 15 336 17 184 18 504 19 742 21 514 22 560 23 592 -999
21 9 560 19 428 20 514 22 243 23 405 -999
22 16 735 17 596 20 560 21 243 23 187 29 232 -999
23 15 779 16 766 17 627 20 592 21 405 22 187 29 81 -999
24 0 309 1 300 2 202 6 405 7 364 8 360 25 179 26 140 27 319 -999
25 0 242 1 234 2 225 3 323 4 258 5 338 6 228 7 290 8 345 11 495 12 200 24 179 26 187 27 343 -999
26 0 391 1 382 2 284 3 492 6 336 6 475 7 286 8 302 24 140 25 187 27 238 -999
27 1 575 2 508 3 631 4 579 5 646 7 424 8 316 24 319 25 343 26 238 -999
28 0 666 1 597 5 412 6 340 7 97 10 427 11 146 12 200 13 377 -999
29 22 232 23 81 -999