8
0 0 0 1 8 2 4 -999
1 1 0 2 5 -999
2 0 3 1 7 2 0 4 9 6 3 -999
3 1 9 3 0 5 4 7 1 -999
4 4 0 6 9 -999
5 5 0 -999
6 4 2 6 0 7 3 -999
7 5 3 6 9 7 0 -999